1 1 1 1 1 1 1 1 1 1 1 1 1 1 1 1 1 1 1 1 1 1 1 1 1 1 1 1 1 1 1 1 1 1 1 1 1 1 1 1 1 1 1 1 1 1 1 1 1 1 
1 1 1 1 1 1 1 1 1 1 1 1 1 1 1 1 1 1 1 1 1 1 1 1 1 1 1 1 1 1 1 1 1 1 1 1 1 1 1 1 1 1 1 1 1 1 1 1 1 1 
1 1 1 1 1 1 1 1 1 1 1 1 1 1 1 1 1 1 1 1 1 1 1 1 1 1 1 1 1 1 1 1 1 1 1 1 1 1 1 1 1 1 1 1 1 1 1 1 1 1 
1 1 1 1 1 1 1 1 1 1 13 14 13 14 13 14 13 14 13 14 13 14 13 14 13 14 13 14 13 14 13 14 13 14 13 14 13 14 13 14 1 1 1 1 1 1 1 1 1 1 
1 1 1 1 1 1 1 1 1 1 15 16 15 16 15 16 15 16 15 16 15 16 15 16 15 16 15 16 15 16 15 16 15 16 15 16 15 16 15 16 1 1 1 1 1 1 1 1 1 1 
1 1 1 1 1 1 1 1 1 1 19 20 19 20 19 20 19 20 19 20 19 20 19 20 19 20 19 20 19 20 19 20 19 20 19 20 19 20 19 20 1 1 1 1 1 1 1 1 1 1 
1 1 1 1 1 1 1 1 1 1 15 16 15 16 15 16 15 16 15 16 15 16 15 16 15 16 15 16 15 16 15 16 15 16 15 16 15 16 15 16 1 1 1 1 1 1 1 1 1 1 
1 1 1 1 1 1 1 1 1 1 19 20 19 20 19 20 19 20 19 20 19 20 19 20 19 20 19 20 19 20 19 20 19 20 19 20 19 20 19 20 1 1 1 1 1 1 1 1 1 1 
1 1 1 1 1 1 1 1 1 1 15 16 15 16 15 16 15 16 15 16 15 16 15 16 15 16 15 16 15 16 15 16 15 16 15 16 15 16 15 16 1 1 1 1 1 1 1 1 1 1 
1 1 1 1 1 1 1 1 1 1 19 20 19 20 17 18 17 18 17 18 17 26 25 26 25 26 25 26 25 18 17 18 17 18 17 18 19 20 19 20 1 1 1 1 1 1 1 1 1 1 
1 1 1 1 1 1 1 1 1 1 15 16 15 16 116 117 117 117 117 117 118 15 16 15 16 15 16 15 16 1 1 1 28 29 29 30 15 16 15 16 1 1 1 1 1 1 1 1 1 1 
1 1 1 1 1 1 1 1 1 1 19 20 19 20 122 120 120 120 120 120 123 19 20 19 20 19 20 19 20 1 1 1 35 40 40 34 19 20 19 20 1 1 1 1 1 1 1 1 1 1 
1 1 1 1 1 1 1 1 1 1 15 16 15 16 114 98 99 99 99 100 114 15 16 15 16 15 16 15 16 28 29 29 39 40 40 34 15 16 15 16 1 1 1 1 1 1 1 1 1 1 
1 1 1 1 1 1 1 1 1 1 19 20 19 20 114 101 102 102 102 103 114 17 18 17 18 17 18 17 18 35 40 40 40 40 40 34 19 20 19 20 1 1 1 1 1 1 1 1 1 1 
1 1 1 1 1 1 1 1 1 1 15 16 15 16 114 104 106 105 106 107 114 113 75 76 76 76 76 77 113 35 40 40 40 40 40 34 15 16 15 16 1 1 1 1 1 1 1 1 1 1 
1 1 1 1 1 1 1 1 1 1 19 20 19 20 115 108 110 109 110 111 114 114 78 79 79 79 79 80 114 35 40 40 40 40 40 34 17 18 19 20 1 1 1 1 1 1 1 1 1 1 
1 1 1 1 1 1 1 1 1 1 15 16 15 16 2 2 4 6 2 2 114 114 81 82 83 79 84 85 114 35 40 40 40 40 40 38 29 30 15 16 1 1 1 1 1 1 1 1 1 1 
1 1 1 1 1 1 1 1 1 1 19 20 19 20 2 2 10 11 2 2 114 114 86 87 88 89 90 91 115 35 40 40 40 40 40 40 40 34 19 20 1 1 1 1 1 1 1 1 1 1 
1 1 1 1 1 1 1 1 1 1 15 16 15 16 1 1 10 11 1 116 125 114 92 93 94 95 96 97 1 27 27 27 27 27 58 59 59 60 15 16 1 1 1 1 1 1 1 1 1 1 
1 1 1 1 1 1 1 1 1 1 19 20 17 18 1 1 10 11 1 119 121 115 1 1 4 5 6 1 1 1 1 1 1 1 61 62 63 64 19 20 1 1 1 1 1 1 1 1 1 1 
1 1 1 1 1 1 1 1 1 1 15 16 1 1 1 1 10 11 1 1 1 1 1 1 10 12 11 1 1 1 1 1 1 1 65 66 67 68 15 16 1 1 1 1 1 1 1 1 1 1 
1 1 1 1 1 1 1 1 1 1 17 18 1 1 1 1 10 11 1 1 1 1 1 1 10 12 11 1 1 1 1 1 1 1 69 70 71 72 19 20 1 1 1 1 1 1 1 1 1 1 
1 1 1 1 1 1 1 1 1 1 1 1 4 5 5 5 12 12 5 5 5 5 5 5 12 12 11 1 1 42 43 44 45 1 1 4 6 1 15 16 1 1 1 1 1 1 1 1 1 1 
1 1 1 1 1 1 1 1 1 1 1 1 7 8 8 8 8 8 8 8 8 8 8 8 8 12 11 1 1 46 47 48 49 1 1 10 11 1 17 18 1 126 126 126 126 126 126 126 126 1 
1 1 1 1 1 1 1 1 1 1 13 14 1 1 1 1 1 13 14 1 1 1 1 1 1 10 11 1 1 50 51 52 53 1 1 10 11 1 1 1 1 126 126 126 126 126 126 126 126 1 
1 1 1 1 1 1 1 1 1 1 15 16 28 29 29 29 30 15 16 98 99 99 100 1 1 10 11 1 1 54 55 56 57 1 1 10 11 1 1 1 1 126 126 126 126 126 126 126 126 1 
1 1 1 1 1 1 1 1 1 1 19 20 35 40 40 40 34 19 20 102 102 102 103 1 1 10 12 5 5 5 5 5 5 5 5 12 12 6 1 1 1 126 126 126 126 126 126 126 126 1 
1 1 1 1 1 1 1 1 1 1 15 16 35 40 40 40 34 15 16 104 105 106 107 1 1 10 12 8 8 8 8 8 8 8 8 8 8 9 1 1 1 126 126 126 126 126 126 126 126 1 
1 1 1 1 1 1 1 1 1 1 19 20 35 40 40 40 34 17 18 108 109 110 111 1 1 10 11 1 1 1 1 1 1 1 1 1 13 14 13 14 1 126 126 126 126 126 126 126 126 1 
1 1 1 1 1 1 1 1 1 1 15 16 35 40 40 40 34 1 1 1 3 1 1 1 1 10 11 1 116 117 117 117 117 117 117 118 15 16 15 16 1 126 126 126 126 126 126 126 126 1 
1 1 1 1 1 1 1 1 1 1 19 20 35 40 40 40 34 1 1 1 1 1 1 1 1 10 11 1 122 98 99 99 100 120 120 123 19 20 19 20 1 126 126 126 126 126 126 126 126 1 
1 1 1 1 1 1 1 1 1 1 15 16 35 40 40 40 34 1 1 1 1 1 1 1 1 10 11 1 114 101 102 102 103 112 112 114 15 16 15 16 1 1 1 1 1 1 1 1 1 1 
1 1 1 1 1 1 1 1 1 1 19 20 35 40 40 40 38 29 29 29 29 30 13 14 1 10 11 1 115 104 105 106 107 112 112 114 19 20 19 20 1 1 1 1 1 1 1 1 1 1 
1 1 1 1 1 1 1 1 1 1 15 16 35 40 40 40 40 40 40 40 40 34 15 16 2 10 11 2 1 108 109 110 111 2 2 114 15 16 15 16 1 1 1 1 1 1 1 1 1 1 
1 1 1 1 1 1 1 1 1 1 19 20 35 40 40 40 40 40 40 40 40 34 19 20 1 10 12 5 5 5 5 6 1 2 2 114 19 20 19 20 1 1 1 1 1 1 1 1 1 1 
1 1 1 1 1 1 1 1 1 1 15 16 35 40 40 40 40 40 40 40 40 34 15 16 2 7 8 8 8 8 8 9 1 1 1 115 15 16 15 16 1 1 1 1 1 1 1 1 1 1 
1 1 1 1 1 1 1 1 1 1 19 20 35 40 40 21 22 21 22 21 22 34 19 20 13 14 13 14 13 14 13 14 13 14 13 14 19 20 19 20 1 1 1 1 1 1 1 1 1 1 
1 1 1 1 1 1 1 1 1 1 15 16 27 27 27 23 24 23 24 23 24 27 15 16 15 16 15 16 15 16 15 16 15 16 15 16 15 16 15 16 1 1 1 1 1 1 1 1 1 1 
1 1 1 1 1 1 1 1 1 1 19 20 13 14 13 25 26 25 26 25 26 14 19 20 19 20 19 20 19 20 19 20 19 20 19 20 19 20 19 20 1 1 1 1 1 1 1 1 1 1 
1 1 1 1 1 1 1 1 1 1 15 16 15 16 15 16 15 16 15 16 15 16 15 16 15 16 15 16 15 16 15 16 15 16 15 16 15 16 15 16 1 1 1 1 1 1 1 1 1 1 
1 1 1 1 1 1 1 1 1 1 19 20 19 20 19 20 19 20 19 20 19 20 19 20 19 20 19 20 19 20 19 20 19 20 19 20 19 20 19 20 1 1 1 1 1 1 1 1 1 1 
1 1 1 1 1 1 1 1 1 1 15 16 15 16 15 16 15 16 15 16 15 16 15 16 15 16 15 16 15 16 15 16 15 16 15 16 15 16 15 16 1 1 1 1 1 1 1 1 1 1 
1 1 1 1 1 1 1 1 1 1 17 18 17 18 17 18 17 18 17 18 17 18 17 18 17 18 17 18 17 18 17 18 17 18 17 18 17 18 17 18 1 1 1 1 1 1 1 1 1 1 
1 1 1 1 1 1 1 1 1 1 1 1 1 1 1 1 1 1 1 1 1 1 1 1 1 1 1 1 1 1 1 1 1 1 1 1 1 1 1 1 1 1 1 1 1 1 1 1 1 1 
1 1 1 1 1 1 1 1 1 1 1 1 1 1 1 1 1 1 1 1 1 1 1 1 1 1 1 1 1 1 1 1 1 1 1 1 1 1 1 1 1 1 1 1 1 1 1 1 1 1 
1 1 1 1 1 1 1 1 1 1 1 1 1 1 1 1 1 1 1 1 1 1 1 1 1 1 1 1 1 1 1 1 1 1 1 1 1 1 1 1 1 1 1 1 1 1 1 1 1 1 
1 1 1 1 1 1 1 1 1 1 1 1 1 1 1 1 1 1 1 1 1 1 1 1 1 1 1 1 1 1 1 1 1 1 1 1 1 1 1 1 1 1 1 1 1 1 1 1 1 1 
1 1 1 1 1 1 1 1 1 1 1 1 1 1 1 1 1 1 1 1 1 1 1 1 1 1 1 1 1 1 1 1 1 1 1 1 1 1 1 1 1 1 1 1 1 1 1 1 1 1 
1 1 1 1 1 1 1 1 1 1 1 1 1 1 1 1 1 1 1 1 1 1 1 1 1 1 1 1 1 1 1 1 1 1 1 1 1 1 1 1 1 1 1 1 1 1 1 1 1 1 
1 1 1 1 1 1 1 1 1 1 1 1 1 1 1 1 1 1 1 1 1 1 1 1 1 1 1 1 1 1 1 1 1 1 1 1 1 1 1 1 1 1 1 1 1 1 1 1 1 1 
